# Deutsch


## Adjectives:

schwer: hard/heavy
normal: normal
leicht: light, easy
einfach: easy
klein: small
groß: big
lang: long
kurz: curt
weit: far, long
hoch: high
tief: deep
rund: round
stark: strong
schwach: weak
sauber: clean
schmutzig: dirty
richtig: correcto
witzig: funny
lustig: funny
traurig: sad
müde: tired
jung: young
neu: new
alt: old
kalt: cold
külh: cool
warm: warm
heiße: hot
schnell: fast
langsam: slow
schön: beautiful
gut: good
süß: sweet (food), cute (beings)
frisch: fresh
lecker: delicious
sauer: acidic
salzig: salty
scharf: spicy/strong/hot
perfekt: perfect
schlecht: sick, bad
frei: gratis
toll: great
super: great
laut: loud
ruhig: sereno
leise: suave
klar: clear
fertig: done, ready
wichtig: important
teuer: expensive
billig: cheap
gratis: free (money)
müde: tired
reicht: enough
schwanger: pregnant
scharf: spicy/strong/hot
reich: rich
ähnlich: similar, alike
leer: empty
voll: full
letz: last
vorbei: passed
fest: firm, stable, compact
regional: regional, local
komplett: complet (all included)
gesund: healthy (enjoy health or provide it)
verheirated: married
geheirated: married
spät: late
verspätet: delayed (ver-spat/-et/part)
ausgezeichnet: excellent great outstanding (aus/out-ge-zeich/marcar zeichnet/marcado)
plötzlich: sudden
automatisch: automatic
hilfreich: helpful
activ: active
relativ: relative
allgemein: general, universal
extrem: extreme
tatsächlich: actualy (based on facts)
original: original
seltsam: strange, odd
wert: worth
falsch: false, wrong
beliebt: popular, admired
echt: genuine true real
wahr: true
privat: privat
sinnvoll: meaningfull (sinn/sense-woll/full)
knapp: scarce	
verantwortlich: responsible (ver-antwort-lich)
bereit: ready
egal: igual, sin importancia
offen: open
gemeinsam: common, mutual, shared
zuständig: competent  responsible (zu/to-stand)
komisch: comic, funny/weird
genau: exact
weich: soft
hart: hard, severe
kaputt: broken
fit: fit, in good shape
fühl: feel (reflexivo) ich fuhle mich

notwendig: mandatory (wendig/flexible)
selbstverständlich: selfexplanatory, intuitive (selb/self-verstehen/understand-lich/y)
eindeutig: definido, inequivoco (ein/one-deuten/interpret-ig/ion)
begeistert: entusiastic (geist/spirit)
verfügbar: available
zufrieden: content, satisfied
sichtbar: visible
unsichtbar: unvisible
abhängig von: adicto a
unabhängig: independent
bekannt: known, familiar
unbekannt unknown, unfamiliar
nützlich: useful (nützen/to profit)
möglich: likely, possible (mögen/may)
unmöglich: imposible (can not happen at all)
praktisch: practical
persönlich: personal
positiv: positive

individuell: individual
international: international
verpflichtet: commited, obliged (pflicht/duty)
kostenlos: gratis
wahrscheinlich: likely, probable (wahr/true-schein/seem-lich/y)
deutlich: claro, obvio, definido



grün: green
schwarz: black
rot: red
weiß: white
blau: blue
gelb: yellow
grau: grey
braun: brown
rosa: pink
bunt: multicolored


### Inflexiones:

- Ninguna: en el predicado
- Debil:
	- definites: das, den...
	- demostratives 'dies-'
	- jeglich- jed- jen-
	- manch- solch- welch-
	- alle derselb- derjenig-
- Mixed:
	- Singular Nom and Acu, like definite, rest with -en
	- indefinte: ein- kein-
	- posesives: mein- dein-...
- Strong:
	- declined like definite articles but with -en in masculine and neutral genitives.
	- no article
	- quantity specified
	- etwas, mehr
	- wenig- viel- mehrer- einig-
	- phrases  ein paar ein bisschenn

#### Strong


g | Nom     | Acu     | Dat     | Gen
--+---------+---------+---------+--------
m | alt_er_ | alt_en_ | alt_em_ | *alt_en_*
n | alt_es_ | alt_es_ | alt_em_ | *alt_en_*
f | alt_e_  | alt_e_  | alt_er_ | alt_er_
p | alt_e_  | alt_e_  | alt_en_ | alt_er_

- most like like definite determinants
- exceptions: gen m and n, which have _-en_

#### Mixed


g | Nom     | Acu     | Dat       | Gen
--+---------+---------+-----------+--------
m | alt_er_ | alt_en_ | *alt_en_* | *alt_en_*
n | alt_es_ | alt_es_ | *alt_en_* | *alt_en_*
f | alt_e_  | alt_e_  | *alt_en_* | *alt_en_*
p |*alt_en_*|*alt_en_*| *alt_en_* | *alt_en_*

- plural or dative or Genitive _en_
- acusative and nominative singulars like determined articles

#### Weak

g | Nom     | Acu     | Dat     | Gen
--+---------+---------+---------+--------
m | alt_e_  | alt_en_ | alt_en_ | alt_en_
n | alt_e_  | alt_e_  | alt_en_ | alt_en_
f | alt_e_  | alt_e_  | alt_en_ | alt_en_
p | alt_en_ | alt_en_ | alt_en_ | alt_en_

- plural or genitive _-en_
- acusative and masculine _-en_
- rest _-e_



## Verbos regulares

renn*e*
- ich (1a)

renn*st*
- du (2a informal)

renn*t*
- er/sie/es (3a)       (er like in 'ear')
- ihr (2a p informal)  (ihr like in 'air')

renn*en*
- wir (2a p) 
- sie (3a p)
- Sie (2a p/s formal)


trink: drink
geh: go
lauf: walk, run (läuft)
renn: correr
reich: bastar
denk: think
lern: learn
beginn: start
spiel: play
lib: love
leb: live
fall: fall (fällt)  
komm: come
heiß: llamarse
schmeck: saber (gusto)
brauch: need
trag: wear, carry (trägt)
spiel: play
mach: make  
schlaf: sleep (schläft)
hör: hear
schreib: write
kenn: know
denk: thank
schwimm: swimm
bring: bring
farh: drive
bezahl: pagar/invitar
wasch: wash (wäscht)
pass: fit
bau: build
offne: open (offne, offnet..)
frag: ask
antworte: answer (e asimilada con -en -e)
zähl: contar
koch: cook
kauf: buy
enkauf: shop
verkauf: sell
kost: cost
überweis: transfer
gewinn: win
besitz: own
sitz: sit
zeig: show
zeig auf: point to
sag: say
folg: follow
helf: help
drucken: shake
versteh: understand, listen
sprech: speak
flieg: fly
ruf: call
bleib: stay
leg: lay
dusch: take a shower/ducharse
hilf: help
gehör: belong to
buch: book/reservar
fehl: be missing
komm an: arrive
ende: end

arbeit: work
sing: sing
hoffe: hope
halt: hold, stop (hälte, hältst, hält, halten, haltet)
pflanz: to plant
münd: to flow into


such: seek, search
gefall: please
änder: change (not anderen but andern)
treff: hit
glaub: believe, have faith
wart: wait
lieg: lie
schein: seem
stell: put, pose
steh: stay stand
erkenn: recognize (er/re-kenn/know)
benutzt
erweitern
erlauben
verpassen
bestelle
übernimmt
schließt
passiert
akzeptieren
abonnieren
spazieren
funktioniert
prüft
sammel: collect
meint
schaut
steigt
fehlt
stiehlt



kennen gegen wissen:
	wissen for facts, subjects, clauses (memory)
	kennen for people, places, concepts (familiarity)

### Presentes Irregulares

spanish: ich du er/sie/es wir/sie/Sie ihr

ser: bin bist ist sind seid
	imperative: sei
comer: esse isst isst essen esst
comer: fresse frisst frisst fressen fresst
gustar: mag magst mag mögen mögt
	(para verbos usar el adverbio 'gerne/gern'-'con placer')
tener: habe hast hat haben, habt
leer: lese liest liest lesen lest
ver: sehe siehst sieht sehen seht
querer: will willst will wollen wollt
dar: gebe gebst _gibt_ geben gebt (es gibt - hay)
take: nehme nimmst nimmt nehmen nehmt
leave/drop: lasse läst läst lassen last
act: handele handelst handelt handeln
saber: weiß weißt weiß wissen wisst (be aware of)
poder: kann kannst kann können könt


### Imperativos

Formal: trinken Sie es (Sie con predicado y sujeto invertidos)
Singular: trink(e) es (se quita las terminaciones o se añade -e)
Plural: trinkt es  (se usa la forma del 'ihr')




## Personal pronoums

Nom | Acu  | Dat   | Gen     |
----+------+-------+---------+
ich | mich | mir   | mein/er | sing 1st
du  | dich | dir   | dein/er | sing 2st
er  | ihn  | ihm   | sein/er | sing 3st masculine
sie | sie  | sie   | ihrer   | sing 3st femenine
es  | es   | ihm   | sein/er | sing 3st neuter
wir | uns  | uns   | unser   | pl 1st
ihr | euch | euch  | euer    | pl 2nd
sie | sie  | ihnen | ihrer   | pl 3st
Sie | Sie  | ihnen | ihrer   | formal 2nd


## Definite determiners

g | Nom | Acu | Dat | Gen |
--+-----+-----+-----+-----+
m | der | den | dem | des |
n | das | das | dem | des |
f | die | die | der | der |
p | die | die | den | der |


## Determiner

g | Nom  | Acu   | Dat   | Gen
--+------+-------+-------+-------
m | ein  | einen | einem | eines
n | ein  | ein   | ein   | eines
f | eine | eine  | einer | einer
p | eine | eine  | einen | einer  (just as ending)

Negative (not a) same as above with a leading 'k'

- kein, keine, keinen, keinem

## Possessive determiner:

Use the same endings as in ein with mein, dein, sein, ihr, unser, euer, Ihr

my:   mein    - meine
your: dein    - deine
his:  sein    - seine
our:  unser   - unsere
yall: eure    - eure
her:  ihr     - ihre
they: ihr     - ihre
you:  Ihr     - Ihre (formal)


# Demostrative determiner

g | Nom    | Acu    | Dat    | Gen
--+--------+--------+--------+-------
m | dieser | diesen | diesem | dieses
n | dieses | dieses | diesem | dieses
f | diese  | diese  | dieser | dieser
p | diese  | diese  | diesen | dieser

shorter 'dies' is often used instead 'dieses'


### Pronoms

alle: everyone
alles: everything
niemand: nobody
jemand: anybody
nichts: nothing
keiner: nobody, noone
wieder: back, again

ein paar: a couple of
ein Paar: a pair (exactly) of
etwas: some (not much)
manche: some (not many)
viel: much, a lot of
viele: many lots of (many)
beide: both (nom,acu) beiden (dat) beider (gen)
jedes: each, everyone
zusammmen: together
gemeinsam: together

### Numerals

They are adjectives, so inflected

n      | 10+n       | 10*n
-------+------------+-----------
eins   | *elf*      | zehn
zwei   | *zwölf*    | *zwanzig*
drei   | dreizehn   | *dreißig*
vier   | vierzehn   | vierzig
fünh   | fünfzehn   | fünfzig
sichs  | *sechzen*  | *sechzig*
sieben | *siebzehn* | *siebzig*
acht   | achtzehn   | achtzig
neun   | neunzehn   | neunzig

hundert:
tausend:
Millionent:
Milliarden:

Ordinals: -te (1-19) -ste (20-*)
Exceptions: erste(1st), dritte(3rd) siebte (7th), achte(8th)



wegen: because of
während: during/while
oft: often
einschließlich: including

hier: here (aqui)
da: here/there (ahi)
dort: there (alli)

das hier: this (esto)
das da: this/that (eso)
das dort: that (aquello)

das Buch hier: this (este libro)
das Buch da: this/that (ese libro)
das Buch dort: that (aquel libro)

drüben: over there
dort drüben: over there (en esa direccion)
oben: upstairs, over, north
unten: downstairs, under, south
drinnen: indoors, inside
draußen: outdoors, outside
innen: inside
außen: outside
hinten: back, at the back
vorne: front, in front of
nebenan: next door
überall: everywhere


## Preposiciones

### acusative

geghen: against
durch: by means of, by, through
ohne: without
für: for, on behalf of, by the standards of
um: around, about (es geht), at (time)
bis: hasta, until by (time), to (place)


### dative

nach: towards
zu: to
aus: out
außer: besides, apart from, sin contar con
mit: with
von: from (place), belonging to, by doer
seit: since, for
gegenüber: opposite, headed to, in front of
bei: by, near

### acusative and dative

accusative: No movement on movement within same
dative: movement from on place to another

auf: on/upon
hinter: behind
an: to/on
unter: under/beneath/among
neben: next to
in: in/into
über: over
zwischen: between
vor: before/in front of


### contractions




## Adverbios

niemals: never
auch: tambien
wirklich: really
so: tan
nur: only
immer: always
noch: still
zu: too (demasiado)
immer notch: still
sussammen: together
dran: on turn
alleine: alone
vieder: again
vielleicht: maybe
schon: already
normalerweise: normally usually (Ha invertido sujeto y predicado)
gewönlich: usually
plötzlich: suddenly

ganz: entirely, totally
sehr: very
ziemlich: pretty, fairly (seamsly)
eher: rather
genug: enough
genau: exactly
weniger: less
mehr: more

als: than(after comparative), as
wie: like, as

## Position of Nicht

- Precediendo el adjetivo o adverbio que niega
- Sigue al verbo que niega si es conjugado "ich essen nich" No estoy comiendo.
- Cuando niega la ocurrencia del pasado, delante del participio "ich habe nicht gegessen" No he comido.
- Al final de la frase en interrogativas
- Al final de la frase si el CD es 'mir'


## Conjunciones

### coordinating

und: and
oder: or
aber: but
denn: dado que
sonderm: but rather (not A, x B)

### subordinating

weil: because
wenn: when
dass: that (que)
obwohl [obful]: even though (aunque) - A, x b
doch: though (aunque) 
solange: as long as - x A, b
da: since - x a, B - A, x b
sobalt: as soon as - A, x b

### correlative

entweder ... oder: either ... or


### Question words

was: what? (declinable como 'das')
    was (nom-acu)
    wessen (gen)
    x (dat) use wo/wor with prepositions
        wohin: what... to
        wofür: what... for
        woüber: what... about
        woran: what... of
        womit: what... with
wer: who? (declinable como 'der')
    wer (nom): who called
    wen (acu): who/whom you call
    wem (dat): who/whom you say this to
    wessen (gen): whose
wieso: why?
warum: why?
wann: when?
wo: where?
woher: where...from?
wohin: where... to?
welcher: which? declension like dieser: welche welchen welchem welches
wie: how
    wie lang: how long?
    wie viel: how much?
    wie viele: how many?
    wie oft: how often?
    wie weit: how far?


irgendwas something
irgendwo: somewhere
irgendwann: sometime
irgendwer: someone
irgendwie: somehow



## Names

### Plural forms:

Se añada sufijo o no puede cambiar de umlaut

-e si es de una silaba
-er (m,n)
-en (f)
-nen si acaba con el sufijo femenino -in: der Kotch-die Kotchin, die Kötche-die Kotchinnen
(x) si acaba en -chen, -lein, -el, -er
-s, -es si origen extrangero

### Die Menschen

die Menschen: people/mankind (p)
der Mensch: human, person
die Leute: person (p)
die Frau: women (f)
der Mann: man (m)
der Junge (m)
das Kind: kid (n)
das Madchen: girl (n)
der Herr: sir
der Bürger: citizen
die Gruppe: group
der Erwachsene: adult (erwach=awaken)
das Publikum: audience
die Dame: lady
der Freund: friend (m)
der Freundin: friend (f)
Vorname: first name
das Baby: bebe
der Gast: guest
das Geschlecht: gender
Vegetarier
der Gegner: oponent, rival
der Feind: enemy
der Besucher: visitor (suchen search)
Mitglied: member
Fan: fan
der Anfänger: beginner
der Nachbar: neighbor
die Nachbarin: neighbor (f)

## Die Familie

Die Familie: familia

die Eltern: parents (p)
die Mutter: mother
der Vater: father
die Mama: mom
der Papa: dad
die Großeltern: grandparents (p)
die Großmutter: grandmother
der Großvater: grandfather
die Oma: grandma
der Opa: grandpa
die Urgroßeltern: great-grandparents
die Urgroßmutter: great grandmother
der Urgroßvater: great grandfather

die Tochter: daughter
der Sohn: son
der Enkel: grandson, grandchild
die Enkelin: granddaughter
der Urenkel: great-grandson, great-grandchild
der Urenkeling: great-granddaughter

die Schwester: sister
der Bruder: brother
der Geschwister: sibling

der Halbbruder: hermanastro
die Halbschwester: hermanastra
der Zwilling: twin

die Tante: aunt
der Onkel: oncle

die Nichte: niece (sobrina
der Neffe: nefew (sobrino)
die Verwandte: pariente
der Cousin: cousin (m)
die Cousine: cousin (f)

die Hochzeit: wedding ("momento alto")

die Beziehung: relation
Verbindung: relation
der Partner: associate
die Partnerschaft: partnership


### Die Natur

der Himmel: sky
der Mond: moon
der Stern: star
der Wind: wind
der Berg: mountain
der Baum: tree
der Wald: forest
der Bach: brook, torrent
der Fluss: river (mündet in Fluss/Strom)
der Strom: stream (mündet in Meer)
der Teich: pond/estanque
der Stausee: dam/edam/mbalse
der See: lake
der Strand: beach
der Bernstein: amber (bern/nacer??-stein/piedra)

die Natur: nature
die Welt: world
die Erde: earth
die Sonne: sun
die Blume: flower
die Luft: air
die Welle: wave
die Umwelt: ecosystem, medi
die Tierwelt: animal kindom, fauna
die Wiese: meadow (prado)
die Wüste: desert
die Landwirtschaft: agricultura

das Feuer: fire
das Rinnsal: trickle, arroyo
das Gras: grass
das All: cosmos
das Klima: climate



Rhein: Rhine river





### Die Tiere

das Tier: animal (n)
das Haustier: pet

die Maus: mouse
die Katze: cat
die Kuh: cow
die Ente: duck

der Hund: dog
der Bär: bear
der Pferd: horse
der Schwein: pig

der Vögel: bird

der Insekt: insect
der Käfer: bettle
die Biene: bee
die Spinne: spider
die Fliege: mosca
die Schneke: snail


## Objects

die Zeitung: newspaper (f)
das Buch: book (n)
das Zeug: stuff
das Feuerzeug: lighter
das Spielzeug: toy
das Fahrzeug: vehicle
das Flugzeug: aeronave
das Werkzeug: tool
die Batterie: bateria
die Heizung: heater (heiz/heat-ung/ing)
die Reiningung: cleaning
der Rucksack: backpack (ruck/espalda-sack/bolsa)
der Umzug: moving, parade (um/hacia-zug/substativated)
das Gerät: device
Haushalt: household, budget
Schlaf: sleep/sueño
Haushaltsgerat: home devices electrodomesticos
die Zahnbrüste: tooth brush
die Zahnpasta: tooth paste
der Raum: room space
die Leiter: lader
der Spiegel: mirror
die Toilette: bathroom
das Tor: goal (sports) different to Tür
der Kühlschrank: fridge (kuhl/frio-schrank/armario)
der Karton: box, cardboard
die Flasche: bottle
die Seife: soap
das Bad: bath
Rasierer: razor shaver
die Dusche: shower
das Shampoo: shampoo
Duschgel: shower gel/ bodywash
das Tuch: cloth
das Handtuch: towel (not needly a *hand* towel)




## Food

das Essen: food
das Frühstück: breakfast
das Mittagessen: lunch (mit tag essen)
der Abendessen: dinner (abend essen)
die Speise: meal, course
die Speisekarte: menu (speise karte)
die Vorspeise: starters (vor speise)
das Hauptgericht: main course (haupt-head gericht-dish)
der Nachtisch: desert
das Getränk: bebida
das Rezept: recipe


das? Wasser: water
der Honig: honey
die Milch: milk
die Tomate: tomato
der Apfel, die Äpfel
das Brot: bread
die Marmelade: jam
der Käse: cheese
der Gemüse: vegetable
die Kartoffel: potato
die Schokolade: chocolate
der Zucker: sugar
der Fleish: meat
der Fisch: fish
das Müsli: cereal
die Butter: butter
die Nuss: nut (pl Nüsse)
das Ei: egg
die Erdbeere: fresas
das Salz: salt
die Nudel: fideo (Nudeln fideos)
das Öl: oil
der Säft: juice
das Obst: fruit
der Hunger: hambre
die Suppe: soup
der Tee: tea
der Wein: wine
der Durst: thirst
das Bier: beer
der Kaffee: coffee
der Reis: rice
das Hähnchen: pollo
der Pilz: mushroom
die Zitrone: lemon
die Zwiebel: onion
die Bohne: bean
der Senf: mustard
der Knoblauch: garlic
der Kuchen: cake
der Spargel: aparagus

das Messer: knife
der Löffel: spoon
die Gabel: fork
der Teller: plate, saucer
das Glas: glass (vaso)
die Schüssel: bowl bol tazón
die Tasse: cup


### Places

das Restaurant (n)
die Bibliotek (f)
der Banhof: train station (m)
die Schule: school
das Haus: house
die Bank: bank
die Brücke: bridge
der Markt: market
der Garten: garden
das Gebäude: building
die Ecke: corner
das Schloss: castle
die Straße: street
das Hotel: hotel
die Stadt: city
der Park: park
das Dorf: village

die Unterkunft: lodging, accomodation
der Platz: square, place
die Insel: island

der Ort: location, village, site
die Kneipe: bar, pub
die Pension: guest house, inn, b&b
der Bereich: area, zone, field
der Flughafen: airport
das Bundesland: estado federado (bund/ligado-land/country)
die Region: region
der Grund: ground, land
der Bezirk: district
der Standort: location, place, site, base for a company
der Hof: farm
das Grundstück: land, property (solar, terreno)
die Zentrale: headquarters
das Zentrum: center
die Halle: hall
die Fläche: surface
die Innenstadt: city center, downtown
das Innere: inside
die Umgebung: environment
Ausland: abroad
Ferienhaus: vacation home
die Heimat: homeland
die Hauptstadt: capital city

wohn: live (wohn in)
wander: hike

gegenüber: across the street

### Home

das Zimmer: room
das Wohnzimmer: sala
das Schlafzimmer: bedroom
die Küche: kitchen

das Fenster: window
die Tür: door
das Dach: roof
der Schlüssel: key
die Wand: wall (pared)
der Deck: cubierta (m)
die Decke: techo (f)
der Zaun: fence
der Balcon: balcony
die Wohnung: apartment (f?)
der Keller: basement
der Hof: courtyard (patio)

das Möbel: furniture, a
der Tisch: table
der Stuhl: chair
das Sofa: couch
der Schrank: cupboard
die Lampe: lamp
das Bett: bed
das Licht: light
der Teppich: carpet, rug
die Steckdose: plug socket (steck-insert + dose-box)
das Ladegerät: cargador (lade-load + gerate-device)


### der Körper

der Körper: body

der Kopf: head
das Auge: eye
das Ohr: ear
der Mund: mouth
der Zahn: tooth
die Nase: nose
die Haare: hair
der Hals: neck

die Hand: hand
der Arm: arm
der Finger: finger

der Rücken: back
die Schulter: hombro
das Herz: heart
die Brust: chest
der Magen: stomach
die Haut: skin
der Fuß: foot
der Bein: leg
das Blut: blood
das Gesicht: face



### Cloth

der Rock: skirt (m)
die Kleidung: cloth
das Kleid: dress
die Jacke: coat 
die Tasche: bag
der Ring: ring
die Kosmetik: maquillaje
der Schuh: shoe
der Mantel: coat
der Knopf: button
der Schmuck: joya
der Fleck: topo
der Hut: hat
das Hemd: camisa
die Hose: pantalon


### Language

die Frage: question
die Antwort: answer


### Numbers, money, measures

die Nummer: number
die Zahl: number (numeral)
der/das Liter: liter
das Prozent: percent (plural just for several figures)
Euro (plural for Euro coins, singular for quantity)
Cent (plural pro Cent coins, singular for quantity)
der Preis: price
der Dollar: Dollar
Geldautomat: ATM
Schweizer Frank: swiss franks
Dutzen: dozen
die Summe: sum
die Hälfte: half
Geld: money
Trinkgeld: tip

Million
die Milliarde: billion/millardo 10^9 eine millarde, zwei milliarden
der Tausend: thousand (the amount) ein Tausend, zwei Tausende
die Tausend: thousand (the figure) die Tausend



### Shopping

der Laden: shop/store (smaller/closer) Läden
der Geschäft: business/store/shop (bigger/professional)
der Marktplatz: marketplace
die Markt: markt
die Supermarkt: supermarket
das Einkaufszentrum: mall
	(Einkauf/purchase-s-zentrum/center)
die Bäckerei: bakery
die Apotheke: pharmacy

der Einkauf: purchase/compra
der Kunde: client (m)
die Kundin: client (f)
der Einkaufswägen: shopping cart
	(einkauf-es-wagen)
die Tüte: shoping bag
der Gutschein: coupon, voucher
das Sonderangebot: bargain/ganga
	(sonder/exclusive, angebot/offer)
die Kasse: checkout (caja)


### Farben/Colors


die Farbe: color, dye


### Travel

der Zug: train (specially vagons)
die Bahn: train (specially railway)
der Urlaub: vacation
das Fahrrad: bicycle
das Motorrad: motorcycle, bike
das Auto: car
der Bus: bus
das Boot: boat
die Fähre: ferry

das Land: country (Länder)
der Pass: passport
das Visum: visa
die Reise: trip
die Fahrt: ride
die Ferien: holidays (p)
der Flug: flight
das Taxi: taxi
der Weg: way
der Stadtplan: citymap
der Reiseführer: tour guide
die Sehenswürdigkeit: sight
	(sehen/see-s-wurdig/worth-keit/ness)
der Tourismus: tourism
der Schweizer: swiss
der Verkehr: traffic
der Mietwagen: rental car (miet/rent-wagen/car)
die Strecke: distance
das Abenteuer: adventure
die Bushaltestelle: bus stop (bus/bus-halte/stop-stelle/position)
der Besuch: visit (suchen search)
die Verspätung: delay (ver/become-spat/be late-ung/ing)


die Schweiz: Schwitzerland (special femenine and determiner required)
Spanien: Spain
Italien: Italy
England: England
Großbritannien: Great Britain
Frankreich: France
Afrika: Africa
Asien: Asia
Europa: Europe
Österreich: Austria
Bayern: Bavaria/Baviera
Schweden: Sweden (Suecia)
Wien: Vienna/Viena
Deutschland: Germany
China: China

der Schwede: Sweden (sueco)
die Schwedin: Sweden (sueca)

### Jobs/Berufe

der Beruf: job
die Arbeit: work
der Geschäftsführer: manager
der Mitarbeiter: coworker (work with)
der Arbeitnehmer: employee (work taker)
der Arbeitgeber: employer (work giver)
der Chef: boss (Chefin)
der Meister: master, foreman

der Hersteller: manufacturer
der Bäcker: baker (Bäckeren, Bäckerin, Bäkerinnen)
der Koch: cook (Köcke, Köchin, Köchinnen)
der Arzt: doctor (Arzte, Ärztin, Ärztinnen)
der Lehrer: (school) teacher (Lehrers, Lehrerin, Lehrerinnen)
der Student: (university) student (Studenten, Studentin, Studentinnen)
der Professor: (university) teacher (Professoren, Professorin, Professorinnen)
der Schüler: pupil (Schülers, Schülerin, Schülerinnen)
der Autor: author
der Bauer: 
der Trainer:
der Bürgermeister: mayor
der Senior: elder citizen
der Händler: trader
der Fahrer: driver
der Verkäufer: seller
die Bedienung: waiter
der Architekt: architect
Feuerwehr: fire brigade


### Materials

die Wolle: wool
die Baumwolle: cotton (lana vegetal)
die Mauer: wall (valla)

der Sand: sand
der Stein: rock
der Beton: concrete
der Stahl: steel

das Gold: gold
das Glas: glass (vidrio)
das Plastik: plastic
das Holz: wood
das Leder: leather
das Papier: paper
das Silber: silver
das Metall: metal
das Kupfer: copper
das Eisen: iron


### Time

der Tag: day
der Werktag: workday
die Woche: week
das Wochenende: weekend

der Anfang: start
der Ende: end
die Vergangenheit: past
die Zukunft: future
der Alltag: daily routine

wochenlich: weekly
täglich: daily
monatlich: monthly
jahrlich: yearly
endlich: finally
bald: soon
danach: then
inzwischen: since then (in between)
spätestens: at the latest (como muy tarde)

Montag: Monday (Mond tag)
Dienstag: Tuesday (Thingsus (god) day)
Mittwoch: Wednesday (in the middle of the week)
Donnerstag: Thursday (Thor Thonare donner day)
Freitag: Friday (frigg/wife day)
Samstag: Saturday (sabbath day)
Sonntag: Sunday (sun day)

Monat: month

Jahr: year
Quartal: quarter (trimester?)
Jahreszeit: season
Saison: seasons
Jahrhundert: century
Alter: age

Frühling: spring
Sommer: summer
Der Herbst
Winter: winter

Januar: January
Februar: Febrary
Der Marz: march
April: april
Mai: may
Juni: june
Juli: july
August: august
September: september
Oktober: october
November: november
December: december

die Phase: phase

Weihnachten: Christmas

der Geburtstag: birthday
der Kalender: calendar
das Datum: date
der Schluss: ending, conclusion

die Große: size

die Medizin: medicine

die Entschuldigung: apology, excuse (ent/dis-schuld/guilt-ig/y-ung/ing)


## afixes

-keit: -ness (adjective -> noun quality of)
-ung: -ing (verb -> noun the fact of doing)
ver-:
be-:



einer von uns: one among us


### die Gesundheit / the health

krank: sick
gesund: healthy
schlecht: bad, sick

blut: bleed

der Patient: patient
das Medikament: medicament
das Pflaster: plaster, tirita
der Rollstuhl: wheel chair
die Praxis: praxis
die Gesundheit: salud
die Untersuchung: examination, investigation
das Formular: form
die Krankheit: enfermedad
die Medizin: medicina
das Krankenhaus: hospital
der Krankenwagen: ambulance
die Krankenversicherung: health insurance
der Unfall: accident
der Notfall: emergency case (Not/emergency-Fall/case)
das Opfer: victim
der Zahnarzt: dentist (m)
die Zahnärztin: dentist (f)
die Klinik: clinic
die Therapie: therapy
der Alkohol: alcohol
die Diät: diet
die Ernährung: nutrition


People 2
Lesson 1
Gemeinde, Vereine, Öffentlichkeit, Verbindung, verhältnisse, Nutzer
Lesson 2
Bevölkerung, Jugend, Einwohner, Paar, besucht, man



Verbs Future 1
Lesson 1
wird, essen, gehen, reden, warten
Lesson 2
bleiben, vergessen, lieben, kosten, wissen, folgen
Lesson 3
testen, rufen, lösen, sprechen, handeln, zählen
Lesson 4
beraten, schützen, bieten, merken, erklären
Tips and notes
The future tense consists of a conjugated form of werden in the present tense and an infinitive (the base form of the verb).
ich werde spielen (werde wirst wird werden werdet)

Feelings
Lesson 1
Liebe, Traum, träumt, Not, Freude, Wunsch
Lesson 2
liebst, Spaß, Ernst, Angst, Eindruck, unheimlich
Lesson 3
Gedanken, Ruhe, Humor, Witz, interessant, langweilig
Lesson 4
Ärger, lieber, ehrlich, witzig, dumm, schlau
Lesson 5
stolz, hassen, Liebling, total, böse, nett, Lust
Lesson 6
tapfer, Verständnis, Schuld, lachen, schlimm, gar, glücke

### Time

die Zeit: time
der Moment: moment
der Augenblick: instant (eye blink)
der Zeitpunkt: moment in time (time point)
der Zeitraum: period
die Dauer: duration
der Termin: deadline
das Mal: ocasion, occurrence
die Uhrzeit: time of day
die Uhr: hora, o'clock, watch
die Stunde: hour
die Minute: minute
die Sekunde: second

der Morgen: morning
der Mittag: noon
der Abend: evening (wider than in english, includes night til midnight)
die Nacht: night, darkness
die Mitternacht: midnight

dann: then (A, dan b)
dann: then (adv. at that time, after that, in that case)
jetzt: now (A(past/future), now b(present))
jetzt: now (adv. in the present)
heute: today (adv)
gestern: yesterday (adv)
morgen: tomorrow (adv)
nachts: at night
sofort: inmediately, at once
halb: partido en dos
viertel: quarter of (un quart de)
etwa: aproximately
fast: almost, nearly
gerade: justamente
damals: then (at that past point of time)
lange: for a long time

früh: early
spät: late, after deadline
später: later, afterwards

dauer: durar (dauere/dauer/daure dauerst dauert dauern dauert)


Frequency
Lesson 1
mehr: more
	kein X mehr (no longer a X)
	nicht mehr X (not much X)
	nichts mehr (nothing more)
	nie mehr (never again)
oft: often
manchmal: sometimes
wenig: few

zahlreich: numerous
häufig: frequent
selten: sheldom
ein bisschen: a bit (Bissen/bit-schen/diminutive)
ob .. oder ...: whether a or b
meist: mostly
keinerlei: not (adj) whatsoever/at all
meisten: superlative of viel
je x desto y: the more x the y
je x je y: the more x the more y

Verbs: Modal

wir mussen diese bucher lesen
can: kann kannst kann können könt
want: will willst will wollen wollt
may: darf darfst darf dürfen dürft
should: soll sollst soll sollen sollt
must: musse musst musst müssen musst


kann swimmen:
muss weg: must go away (falta el geh??)
sein:
soll machen: should do

ich will en Vater sein

tun: do
finde: find
miet: rent
bestatig: confirm
möcht: would like (subjunctive mag)
red: talk
benutz: use
weck: wake
wiederhol: repeat

mitmach: participar (mit/with-mach/make)
teilnehm: join, take part (teil/part-nehm/take)
registrier: register
entscheid: judge, decide (ent/dis-scheid/split)
ersetz: replace (er-setz/sit)
spazier: walk
vorstell: introduce (vor/first-stell/put)
aussag: state (declarar) (say out)
betracht: look, consider (be/previ a-tracht/try)

der Verein: society, club, association

bösse: angry
ehrlich: honest

Adverbs 2
weder, sowohl, bereits, selbst, damit, darüber, allein
nun, dabei, dazu, selber, zuerst, zuletzt, genauso
daher, sonst, einmal, jedenfalls, völlig, durchaus, mindestens
meistens, außerdem, besonders, kaum, überhaupt, jedoch, erneut


Genitive Case

Tips and notes
The genitive case

The genitive case is used to indicate possession.

Das Fahrrad des Mannes ist schwarz.
Das Fahrrad des Kindes ist blau.
Das Fahrrad der Frau ist grün.
	masculine 	neuter 	feminine
nominative 	der 	das 	die
accusative 	den 	das 	die
dative 	dem 	dem 	der
genitive 	des 	des 	der

Das Fahrrad eines Mannes ist schwarz.
Das Fahrrad eines Kindes ist blau.
Das Fahrrad einer Frau ist grün.
	masculine 	neuter 	feminine
nominative 	ein 	ein 	eine
accusative 	einen 	ein 	eine
dative 	einem 	einem 	einer
genitive 	eines 	eines 	einer
Nouns

Nouns consisting of one syllable tend to add -es in the masculine and neuter. The ending is often reduced to just -s, especially in colloquial speech.

Nouns consisting of more than one syllable, tend to add just -s.

Weak nouns add -n or -en in the genitive as well (all cases but the nominative), e.g. des Jungen and des Studenten.
Genitive phrases have a fixed word order

You can say das Fahrrad des Kindes, but you cannot say des Kindes Fahrrad. The latter word order used to be acceptable hundreds of years ago, and you may still occasionally find it in poetry, but it’s no longer used in contemporary Standard German .
Proper names

In contrast to common nouns, proper names precede the noun.

Peters Fahrrad ist neu.

Do not add an apostrophe unless the name already ends in -s or -z. In the latter case, the apostrophe comes at the very of the name.

Hans’ Fahrrad ist alt.
Adjectives

Adjectives describing singular masculine and singular neuter nouns always add -en.

Adjectives describing singular feminine nouns and plural nouns of any gender add -en (if preceded by an article) or -er (if not preceded by an article).
	preceded by an article 	not preceded by an article
masculine 	das Fahrrad des großen Mannes 	wegen neuen Termins
feminine 	das Fahrrad der kleinen Frau 	trotz großer Freude
neuter 	das Fahrrad des kleinen Kindes 	trotz ruhigen Wesens
plural (any gender) 	das Fahrrad der kleinen Kinder 	wegen neuer Informationen
Prepositions that take the genitive case

The most common prepositions that take the genitive case are anstatt (instead of), aufgrund (because of), statt (instead of), trotz (despite/in spite of), während (during), and wegen (because of).

In colloquial speech, some prepositions that are supposed to take the genitive sometimes take the dative.
Verbs that take the genitive case

There’s a small set of verbs that take genitive. Most of them are not used a lot in everyday speech and they may sound a bit stilted.
The dative as an alternative

As an alternative for the genitive, you can use von followed by the dative case, e.g. das Fahrrad von dem Mann, das Fahrrad von der Frau, das Fahrrad von dem Kind, das Fahrrad von Peter. Mind you, the genitive case is usually preferred in terms of style.

Occupation 2
Lesson 1
Verfasser, Betreiber, Entwickler, personal, Empfänger, Teilnehmer
Lesson 2
Werkstatt, Handwerk, Schneider, Hersteller
Lesson 3
Richter, Spezialität, Richterin, Experten, rechtsanwälte



Verbs: Perfect 1
Lesson 1
hat, gegessen, gesehen, gelernt, gelesen, geschlafen, gespielt
Lesson 2
behalten, erfahren, veröffentlicht, beraten, verbessert, besucht, gegeben
Lesson 3
geschrieben, ist, geschwommen, gelaufen, gekommen, geworden, gefragt, gestohlen
Lesson 4
interessiert, informiert, verletzt, gegangen, gefallen, erzählt, gerannt, gewesen
Lesson 5
getrunken, gehabt, gekocht, gesprochen, gemacht, gesucht, gefunden, überwiesen
Lesson 6
gesagt, gemocht, gestellt, verkauft, vergessen, bestellt, geladen, geschehen

Tips and notes
When is the Perfekt used?

The Perfekt is used to describe past events. In spoken German, the Perfekt is preferred over the Präteritum. Using the Präteritum in normal conversation may sound unnatural or pretentious.

There are a few exceptions to this rule of thumb. sein (to be), haben (to have), wissen (to know), and the modal auxiliaries dürfen (to be allowed to), können (to be able to), müssen (to have to), sollen (to be supposed to), wollen (to want to) are used in the Präteritum in informal contexts as well.

In contrast to the English present perfect, the German Perfekt is not used to describe events that started in the past and are still ongoing. In such cases, German speakers use the present tense, e.g. I have been living here for three years translates to Ich lebe seit drei Jahren hier.
How is the Perfekt formed?

The Perfekt is formed by combining a conjugated form of haben (to have) or sein (to be) in the present tense with the past participle of the main verb.

The vast majority of verbs take haben. Verbs that take sein have to be intransitive, i.e. they can't take an object, and they have to indicate a change of position or condition. sein (to be), bleiben (to stay), and passieren (to happen) take sein even though they don't indicate a change of position or condition.

In order to form the past participle of a weak verb, add the prefix ge- and the suffix -t or -et to the stem, e.g. machen (to do/to make) becomes ge-mach-t.

machen (to do/to make)
Präsens 	Perfekt
ich mache (I do/make) 	ich habe gemacht (I have done/made)
du machst (you do/make) 	du hast gemacht (you have done/made)
er/sie/es macht (he/she/it does/makes) 	er/sie/es hat gemacht (he/she/it has done/made)
wir machen (we do/make) 	wir haben gemacht (we have done/made)
ihr macht (you do/make) 	ihr habt gemacht (you have done/made)
sie/Sie machen (they/you do/make) 	sie/Sie haben gemacht (they/you have done/made)

laufen (to run/to walk)
Präsens 	Perfekt
ich laufe (I run) 	ich bin gelaufen (I ran/have run)
du läufst (you run) 	du bist gelaufen (you ran/have run)
er/sie/es läuft (he/she/it runs) 	er/sie/es ist gelaufen (he/she/it ran/has run)
wir laufen (we run) 	wir sind gelaufen (we ran/have run)
ihr lauft (you run) 	ihr seid gelaufen (you ran/have run)
sie/Sie laufen (they/you run) 	sie/Sie sind gelaufen (they/you ran/have run)

Strong verbs add the prefix ge-, change the stem vowel or the entire stem, and add the suffix -t, -et or -en, e.g. nennen (to call) becomes ge-nann-t, sein becomes ge-wes-en, sprechen (to speak/to talk) becomes ge-sproch-en. These forms are not quite predictable. You need to memorize them.

A separable prefix will precede the ge- prefix, e.g. aufmachen (to open) becomes auf-ge-mach-t.

An inseparable prefix will replace the ge- prefix, e.g. veröffentlichen (to publish) becomes ver-öffentlich-t.

Verbs that end in -ieren will not be prefixed, e.g. informieren becomes informier-t.

For complete conjugation charts, check out Canoo and Verbix.


Adjectives: Nominative 1
Lesson 1
müde, größten, größte, öffentliche, neuen, letzter
Lesson 2
eigener, höheren, aktuelle, speziellen, gesamte, internationalen, hohen
Lesson 3
übrigen, öffentlichen, einzelnen, jugendliche, zusätzliche, alte
Lesson 4
notwendigen, hoher, nächster, neues, linken, hohe
Lesson 5
normalen, wichtigsten, richtige, internationale, private, zufälliger
Lesson 6
besonderen, passenden, weiterer, interessante, wichtigen, passende

Adjectives: Accusative
Lesson 1
neue, neues, deutschen, nächsten, neuen, detaillierte
Lesson 2
langen, neuen, ganzen, neue, verschiedenen
Lesson 3
zuständigen, verschiedene, starken, lange, höhere, offenen, komplette
Lesson 4
weiteres, modernen, gemeinsame, alte, eigene, persönlichen, technischen, jungen
Lesson 5
weitere, vergangenen, einzige, eigene, hohe, zweite, wichtige
Lesson 6
eigenen, normalen, gleiche, kostenlose, ehemaligen, kostenlosen





